#############################################################
#S#       #         #             #     #                 # #
# # ### ### # ####### ####### # ### # ### ##### # ####### # #
# # #   #   #         #     # #     #     #   # # #     #   #
# # # ### ######### ### ### ### ########### # ### ### ##### #
#   #     #       # # # # #   #     #       #   #   #     # #
# ######### ##### # # # # ### ### ### ######### ### # # ### #
#       #   #   # #   # #   # #   #   #       # #   # #     #
##### ### ### # # ##### # # # ##### ### ####### # ### #######
#     #   #   # # #     # # #       #         #   # # #     #
# ##### ### ##### # ##### # ######### ####### ##### # # #####
# #   #   #         #   # #   #     # #     #       # #     #
# ### ### ########### ### ### # ### # # ### # ####### ##### #
#       #   #       # #   #   # # # # # #   # #       #     #
# ######### # ##### # # ### ### # # # # # # # # ####### ### #
# #   #     #     # # #   #     # #   # # # # # #       #   #
### # # ### ##### # # ### ####### ####### ### # # ###########
#   # # #       # # #     #         #   #   #   #           #
# ### # ####### # # ### ####### ### # # ### ############### #
# #   #   #   # # #   #   #     # #   #                   # #
# ### ### # # # # ### ### # ##### ####################### # #
#   #     # # # #   #   # #   # #   #   #               # # #
# # ##### # # ### ##### # # # # # # # # # ######### ### # # #
# # #     # #     #     # # # #   #   #   #       # #   # # #
# # # ##### ####### ##### ### ##### ####### ##### # # ### # #
# # #     #   #     #   #   #     #   #     # #     #   #   #
# # ### ##### # ####### ### ##### ### # ##### # ########### #
# #   # #     #   #       # #     # # # #       #           #
# ### # # ####### # # ### # # ##### # # ####### # ###########
# #   # #   #     # # #   #   #     # #   #   # #       #   #
# # ### ### # ####### ####### ### # # ### # # # ####### ### #
# # # # # # #       #         # # #   # #   # # #     #   # #
### # # # # ####### # ######### ##### # ##### # # ### ### # #
#   #     # #   #   # #   #     #   #   #   # #   # # #   # #
# ######### # ### ##### # # ##### # ### # ### ##### # # ### #
#   #       # #   #     # # # #   # #     #   #   #   # #   #
# # # ####### # ### ##### # # # # # ####### ##### # ### ### #
# #         # #       #   # # # # #         #     #   #   # #
# ######### # ######### ### # # # ########### ####### ### # #
# #     #   #   #       #   #   #       # #             #   #
### ### # ### # # ##### # ### ######### # # ####### ####### #
#   # # #   # # # #     # #   #       # # # #     # #     # #
# ### # ### # ### # ##### # ### ##### # # # # ### ### # ### #
# #       #   #   # # #   # # #     #   #   #   #     #     #
# # ##### ##### ### # # ### # ##### ####### ### #############
# # #   # #     #     # # #   #   #       # #   #     #     #
# ### # # # ##### ##### # ### # # ####### ### ### ### # ### #
# #   # # #   # # # #   #     # #       #   # #   # # #   # #
# # ### # ### # # # # ##### ### ##### ##### # # ### # # ### #
#   #   #     #     #     # # # #   #     # # # #   #   #   #
##### ############# ##### # # # # # ### ### # # # ##### # # #
#   # #           # #   # # #     #   # #   # #   #   # # # #
# # # # ######### ### # # # ########### # ### ##### # # # # #
# # # #       # #     #   #             #   #   #   # # # # #
# # # ####### # ##################### ##### ### # ### # # ###
# # #         #     #       #         #       #   # # #E#   #
# # ########### # ### ### # # ######### ########### # ##### #
# #           # #   #   # # #       # # #   #       #     # #
# ############# ### ### # ######### # # # # # ##### ##### # #
#                 #     #             #   #       #         #
#############################################################
