###############################
#     #       #       #       #
# # # # ##### # ##### # ### ###
# # #   #       #   # #   #   #
# # ### ######### # # ####### #
#S# # # #         # #   #     #
### # # # ######### ### # ### #
#   #   # #     #   #   #   # #
# ### ### # # ### ### ##### # #
#   # # # # # # #   #   #   # #
### # # # ### # ### ### # ### #
#   #   # #   #     # # # #   #
# ### ### # ######### # # # ###
#   # #   #     #   #   # # # #
# # ### ### # ### # # ### # # #
# #     #   #     #       #  E#
###############################
